[Egypt]
Alexandria Aquarium - Alexandria
El Gouna Aquarium - El-Gouna
Hurghada Grand Aquarium, Hurghada

[Morocco]
Morocco Mall Aquarium - Casablanca

[Namibia]
National Marine Aquarium of Namibia - Swakopmund

[South Africa]
Two Oceans Aquarium - Cape Town
UShaka Marine World - Durban

[China]
Beijing Underwater World - Beijing (1998) [2][3]
Chime-Long Ocean Kingdom - Hengqin, Zhuhai (2014)
Hefei Oceanarium - Hefei (future)[3][4]
Hangzhou Polar Ocean Park - Hangzhou (2008)
Nanjing Underwater World - Nanjing (1996)
Polar Ocean World - Qingdao (2006)
Polar World - Dalian (2002)
Qingdao Underwater World & Quingdao Aquarium (1932) - Shandong
Shanghai Ocean World - Chang Feng Park, Shanghai (1999)
Shanghai Ocean Aquarium - Shanghai (2002)
Sun Asia Ocean World - Dalian (1994)

[Hong Kong]
Ocean Park - Nam Long Shan, Hong Kong (1977)

[Indonesia]
SeaWorld Indonesia - Jakarta [1]

[India]
Main article: List of aquaria in India

[Iran]
Kish Aquarium - Kish island
Tehran Aquarium - Jajrood, Tehran Province

[Israel]
Eilat aquarium

[Japan]
Main article: List of aquaria in Japan

[Kuwait]
Kuwait Scientific Center - Salmiyah, Kuwait City

[Malaysia]
Aquaria KLCC - Kuala Lumpur
Underwater World Langkawi - Cenang Beach, Langkawi Island
The Green Connection - Kota Kinabalu, Sabah

[Pakistan]
Clifton Fish Aquarium, Karachi

[Philippines]
Mactan Island Aquarium - Maribago, Lapu-Lapu City, Cebu
Malabon Zoo and Aquarium - Governor Pascual Street, Potrero, Malabon City
Manila Ocean Park - Ermita, Manila
Ocean Adventure - Subic, Zambales

[Singapore]
Marine Life Park - Sentosa
River Safari
Underwater World - Sentosa
Van Kleef Aquarium - closed 1991

[South Korea]
63 Seaworld - Seoul
COEX Aquarium - Seoul
Busan Aquarium - Busan
Daejon Aquaworld - Daejon
Aquaplanet Yeosu - Yeosu
Aquaplanet Jeju - Jejudo

[Taiwan]
National Museum of Marine Biology and Aquarium - Taiwan

[Thailand]
Bangkok Aquarium - Bang Khen, Bangkok
Bueng Chawak Aquarium - Doem Bang Nang Buat, Suphanburi
Phuket Aquarium - Phuket
Rayong Aquarium - Rayong
Siam Ocean World - Siam Paragon, Pathum Wan (Siam), Bangkok
Underwater World Pattaya - Pattaya, Chonburi
Chiang Mai Zoo Aquarium - Chiang Mai Zoo, Chiang Mai

[United Arab Emirates]
Dubai Aquarium and Underwater Zoo - Dubai
Sharjah Aquarium - Sharjah[5]

[Vietnam]
Tri Nguyen Aquarium, Nha Trang
Tuan Chau Aquarium, Ha Long Bay
Vinpearl Underwater World, Nha Trang[6]

[Austria]
Haus des Meeres - Vienna Haus des Meeres

[Belgium]
Aquatopia (Antwerp)
Dubuisson Aquarium (Liège)
Sea Life Centre (Blankenberge)

[Bulgaria]
Varna Aquarium

[Croatia]
Akvarij Crikvenica (Aquarium Crikvenica) - Crikvenica
Akvarij Dubrovnik, Instituta za more i priobalje (Dubrovnik Aquarium, Institute for Marine and Coastal Research) - Dubrovnik

[Cyprus]
Ocean Aquarium - Famagusta

[Denmark]
AQUA Akvarium & Dyrepark - Silkeborg[7]
Denmark's Aquarium (Danmarks Akvarium) - Kastrup
Kattegatcentret- Grenå
Nordsøen Oceanarium - Hirtshals
Øresundsakvariet - Elsinore

[Finland]
Akvaariolinna, the Aquarium Castle - Petikko, Vantaa
Kiela Naturium - Muonio, Lapland
Maretarium - Kotka
Sea Life Helsinki, near the Linnanmäki Amusement Park - Helsinki
Särkänniemi Aquarium - Tampere

[France]
Aquarium de Paris - Cinéaqua - Paris (open in 1867 as "Aquarium du Trocadéro", closed in 1985, re-opened as "Cinéaqua" in 2006)
Aquarium tropical de la Porte Dorée - Paris (1931, situated in the Palais de la Porte Dorée)
Aquarium de La Rochelle - La Rochelle (2001)
Aquarium du Grand Lyon - Lyon
Aquarium du Musée de Zoologie - Nancy (1970)
Aquarium du Val de Loire - Between Amboise and Tours, France on the southern shore of the River Loire[8]
Centre de la Mer et des Eaux (closed 2010) - Paris
Citadel of Besançon - Besançon
Great Aquarium Saint-Malo (1996)
Kélonia - Saint-Leu, Réunion
La Cité de la mer - Cherbourg (2002)
Le Musée de la mer - Biarritz (1933)
L'Aquashow - Audierne (2000)
Aquarium Mare Nostrum Montpellier - Montpellier (2007)
Nausicaä Centre National de la Mer - French National Sea Experience Centre, Boulogne-sur-Mer (1991)
Océarium - Le Croisic (1992)
Océanopolis - Brest (1990)
Sea Life Centre Paris - Marne la Vallée (2001)
Seaquarium Le Grau du Roi - Petite Camargue (1989)[9]

[Germany]
Aquarium Berlin at the Berlin Zoological Garden - Berlin
Aquazoo - Düsseldorf (closed for renovations until Spring 2015)
Ozeaneum - Stralsund
Sea Life Centre Timmendorfer Strand - Timmendorfer Strand
Sea Life Centre Berlin and AquaDom - Berlin
Sea Life Centre Dresden - Dresden
Sea Life Centre Munich - Munich
Sea Life Centre Konstanz - Konstanz
Sea Life Centre Speyer - Speyer
Sea Life Centre Oberhausen - Oberhausen
Sea Life Centre Nürnberg - Nürnberg
Sea Life Centre Königswinter - Königswinter
Sea Life Centre Hanover - Hanover
Tropen-Aquarium Hagenbeck at the Tierpark Hagenbeck - Hamburg

[Greece]
Aquaworld Aquarium - Hersonissos, Crete [2]
Cretaquarium - Crete[10]

[Hungary]
Tropicarium - Óceanárium - Budapest

[Ireland]
Galway Atlantaquaria (National Aquarium of Ireland) - Galway[11]
Dingle Oceanworld - Dingle[12]
Sea Life Bray - Bray[13]

[Italy]
Alghero Aquarium - Alghero
Aquarium of Cattolica, Cattolica[14]
Aquarium of Genoa - Genoa
Aquarium of Leghorn - Leghorn[15] 43.5355°N 10.2993°E
Civic Aquarium of Milan - Milan
Stazione Zoologica di Napoli - Naples, opened 1874[16]
Sea Life Gardaland, Gardaland, Lake Garda, Italy

[Lithuania]
Lithuanian Sea Museum, Klaipėda[17]

[Luxembourg]
Wasserbillig Aquarium, Wasserbillig

[Monaco]
Oceanographic Museum and Aquarium - Monaco-Ville

[Netherlands]
Aqua Zoo Friesland - Leeuwarden
Burgers Zoo - Arnhem
Diergaarde Blijdorp (Oceanium) - Rotterdam
Dolfinarium Harderwijk - Harderwijk
Sea Life Centre - Scheveningen

[Norway]
Bergen Aquarium - Bergen
Risør Aquarium - Risør[18]
Altanterhavsparken - Ålesund[19]

[Poland]
Gdynia Aquarium Sea Fisheries Institute Aquarium - Gdynia
Aquarium and Natural History Museum in Kraków - Kraków
Aquarium in Łódź - Łódź
Seal Sanctuary in Hel - Hel
Aquarium in Cracow City Zoo - Kraków
Aquarium in Warsaw City Zoo - Warsaw
Aquarium in Breslau City Zoo - Wrocław

[Portugal]
Lisbon Oceanarium - Lisbon
Aquário Vasco da Gama - Algés (near Lisbon), opened 1898
Fluviário de Mora - Mora, Portugal, Alentejo (100 km East of Lisbon), opened 2007
Sea Life Centre Porto - Porto

[Russia]
Akuliy Rif - Eisk (2007)
Gelendzhik Oceanarium - Gelendzhik (2007)
Moscow Oceanarium - Moscow (building)
Murmansk Oceanarium (ru) - Murmansk (1991)
Planeta Neptun (ru) - Saint Petersburg (2006)
Primorsky Oceanarium (ru) - Vladivostok (being built, not yet open)
Sochi Discovery World (ru) - Sochi (2009)
Vladivostok Oceanarium (ru) - Vladivostok (1991)
Voronezh Oceanarium (ru) - Voronezh (2011)

[Romania]
Acvariu Constanţa - Constanţa (1958)
Danube Delta's Aquarium - Tulcea
Acvariu Zoo Timişoara - Timişoara

[Slovenia]
Akvarij - Terarij - Maribor

[Spain]
Palma Aquarium - Palma de Mallorca
Aquarium Finisterrae - A Coruña
Sea Life Centre Benalmádena - Benalmádena, Málaga
Aquarium Barcelona - Barcelona
Barcelona Zoo - Barcelona
Zoo Aquarium de Madrid - Madrid
L'Oceanogràfic at the Ciutat de les Arts i les Ciències - Valencia
Museu de la Ciencia
Aquopolis La Pineda
Aquarium Donostia-San Sebastián - San Sebastián
River Aquarium - Zaragoza

[Sweden]
Skansen Aquarium - Stockholm
Stockholm Aquarium, - Stockholm
Universeum - Gothenburg
Shipping Museum Aquarium - Gothenburg
Kolmarden Tropicarium - Kolmarden[20]
Malmö Museum Aquarium - Malmö[21]

[Turkey]
TurkuaZoo - Istanbul
Istanbul Aquarium - Istanbul
Aqua Kingdom (Deniz Dunyasi) - Ankara
Aqua Vega - Ankara[22]
Antalya Aquarium - Antalya[23]
Kaplikaya Aquarium (Kaplikaya Cazibe Merkezi Akvaryum) - Bursa
Eti Aquarium (Eti Akvaryum) - Eskisehir

[Ukraine]
Nemo Public Aquarium - Odessa, Kharkiv, Donetsk

[United Kingdom]
Anglesey Sea Zoo - Isle of Anglesey, Wales
Biota! - London, England (planned, but cancelled)
Blackpool Tower Aquarium, Blackpool, England
Blue Planet Aquarium - Ellesmere Port, England
Blue Reef Aquarium - Centres at Newquay, Portsmouth, Hastings, Bristol and Tynemouth in England
Cannon Aquarium - Manchester, England
Cornish Seal Sanctuary - Gweek, England
The Deep - Kingston upon Hull, England
Deep Sea World - North Queensferry, Scotland
Exploris - Portaferry, Northern Ireland
Hastings Underwater World - Hastings, England
Horniman Museum Aquarium - London, England
Hunstanton Sea Life Sanctuary - Hunstanton, England (part of the Sea Life Centres chain)
Isle of Purbeck Aquarium - Wareham, Dorset, England
Lake District Coast Aquarium - Maryport, Cumbria, England
Lakes Aquarium - Lake District, England
Sea Life London Aquarium - London, England
Macduff Aquarium - Macduff, Scotland
National Marine Aquarium - Plymouth, England
National Sea Life Centre - Birmingham, England (part of the Sea Life Centres chain)
Natureland Seal Sanctuary, Skegness, Lincolnshire, England
Oceanarium Bournemouth, - Bournemouth, England
Rhyl Sea Life Aquarium - Rhyl, Wales
St Andrews Aquarium - St Andrews, Scotland
Scottish Sea Life Sanctuary - Oban, Scotland (part of the Sea Life Centres chain)
Sea Life Centres - Centres at Blackpool, Brighton, Great Yarmouth, Scarborough and Weymouth in England and Loch Lomond in Scotland
Sealife Adventure - Southend, England
SeaQuarium - Weston-super-Mare, England

[The Bahamas]
The Dig at Atlantis Paradise Island - Atlantis Paradise Island, Nassau
Dolphin Encounters at Blue Lagoon Island - Nassau

[Canada]
Main article: List of aquaria in Canada

[Mexico]
Acuario Mazatlán - Mazatlán

[Veracruz]
Acuario de Veracruz - Veracruz

[United Status]
George F. Crozier Estuarium - Dauphin Island
McWane Science Center - Birmingham
Alaska SeaLife Center - Seward
Sea Life - Tempe
Wildlife World Zoo and Aquarium - Litchfield Park
National Park Aquarium - Hot Springs
Kelp forest exhibit at the Monterey Bay Aquarium
Aquarium of the Bay - San Francisco
Aquarium of the Pacific - Long Beach
Birch Aquarium - La Jolla
Cabrillo Marine Aquarium - San Pedro
Monterey Bay Aquarium - Monterey
Santa Monica Pier Aquarium - Santa Monica
Sea Life - Carlsbad
SeaWorld San Diego - San Diego
Steinhart Aquarium - San Francisco
Downtown Aquarium - Denver
Maritime Aquarium at Norwalk - Norwalk
Mystic Aquarium & Institute for Exploration - Mystic
National Aquarium - Washington, D.C. -- closed 9/30/2013
Clearwater Marine Aquarium - Clearwater[1]
Dolphin Research Center, Grassy Key
Florida Aquarium - Tampa
Gulfarium - Fort Walton Beach[2]
Key West Aquarium - Key West
Miami Seaquarium - Miami
Mote Marine Laboratory - Sarasota
Pier Aquarium - St. Petersburg[3]
SeaWorld Orlando - Orlando
Tarpon Springs Aquarium - Tarpon Springs[4]
The Seas with Nemo & Friends - Orlando
Bo Ginn Aquarium - Millen[5]
Flint RiverQuarium - Albany
Georgia Aquarium - Atlanta
UnderWater World Guam - Tumon
Maui Ocean Center - Maui
Sea Life Park Hawaii, Honolulu
Waikiki Aquarium, Honolulu
Idaho Aquarium - Boise
Shedd Aquarium - Chicago
National Mississippi River Museum & Aquarium - Dubuque
Newport Aquarium - Newport
Aquarium of the Americas - New Orleans
Gulf of Maine Research Institute - Portland
Maine Aquarium (closed; plans for re-opening dependent on fundraising) - Saco
Maine State Aquarium - Boothbay Harbor
National Aquarium in Baltimore - Baltimore
Berkshire Museum - Pittsfield
Boston Aquarial and Zoological Gardens - Boston (closed)
Maria Mitchell Aquarium - Nantucket
New England Aquarium - Boston
Woods Hole Science Aquarium - Woods Hole[6]
Belle Isle Aquarium - Detroit
John Ball Zoological Garden - Grand Rapids
Great Lakes Aquarium - Duluth
SEA LIFE Minnesota Aquarium - Bloomington
Wonders of Wildlife Museum & Aquarium - Springfield
World Aquarium - St. Louis[7]
Kansas City Sea Life Aquarium - Kansas City[8]
Ak-Sar Ben Aquarium - Schramm Park State Recreation Area, Omaha
Henry Doorly Zoo - Omaha
Shark Reef at Mandalay Bay - Las Vegas
Seacoast Science Center - Rye
Adventure Aquarium (formerly the New Jersey State Aquarium) - Camden
Jenkinson's Aquarium - Point Pleasant Beach[9]
Marine Mammal Stranding Center - Brigantine
Trenton Aquarium - Trenton
The Atlantic City Aquarium - Atantic City
Albuquerque Aquarium - Albuquerque
Atlantis Marine World - Riverhead
Aquarium of Niagara - Niagara Falls
New York Aquarium - Brooklyn
Discovery Place - Charlotte
SciQuarium - Greensboro
North Carolina Aquarium at Fort Fisher - Kure Beach
North Carolina Aquarium at Pine Knoll Shores - Pine Knoll Shores
North Carolina Aquarium on Roanoke Island - Roanoke Island
SEA LIFE Charlotte-Concord Aquarium - Concord
Columbus Zoo and Aquarium - Columbus
Greater Cleveland Aquarium - Cleveland
Oklahoma Aquarium - Tulsa
Hatfield Marine Science Center - Newport
Portland Aquarium - Oak Grove
Oregon Coast Aquarium - Newport
Seaside Aquarium - Seaside
Oregon Undersea Gardens - Newport, Oregon
Philadelphia Aquarium - Philadelphia (1911–1962)
PPG Aquarium - Pittsburgh
Oceans Aquarium Research & Science Center - Coventry, Rhode Island
Ripley's Aquarium - Myrtle Beach[10]
South Carolina Aquarium - Charleston
Ripley's Aquarium of the Smokies - Gatlinburg[11]
Tennessee Aquarium - Chattanooga
Austin Aquarium - Austin
Caldwell Zoo Aquarium - Tyler
Children's Aquarium at Fair Park, Dallas[12]
Dallas World Aquarium - Dallas
Downtown Aquarium - Houston
Kipp Aquarium, Houston[13]
Moody Gardens Aquarium - Galveston
Richard Friedrich Aquarium, San Antonio
SeaWorld San Antonio - San Antonio
Seven Seas Marine Life Park - Arlington
Texas State Aquarium - Corpus Christi
The Living Planet Aquarium - Draper
ECHO Lake Aquarium and Science Center - Burlington
Virginia Aquarium & Marine Science Center - Virginia Beach
Point Defiance Zoo & Aquarium - Tacoma
Seattle Aquarium, Seattle
Reiman Family Aquarium at Discovery World - Milwaukee

[Argentina]
Mundo Marino- Largest Oceanarium in Latin America
Mar del Plata Aquarium
Buenos Aires Aquarium (Acuario de Buenos Aires) - It is inside the Buenos Aires Zoo

[Brazil]
Acqua Mundo
Aquario de Ubatuba
Aquário de São Paulo
Aquário Municipal de Santos

[Colombia]
Rodadero Sea Aquarium and Museum

[Venezuela]
Valencia's Aquarium (Acuario de Valencia)

[Caribbean]
Bermuda Aquarium, Museum and Zoo

[Cuba]
Baconao Park
Freshwater Public Aquarium, Havana

[French Antilles]
Aquarium de la Guadeloupe - Gosier, Guadeloupe

[Australia]
Main article: List of aquaria in Australia

[Guam]
Underwater World - Tumon

[New Caledonia]
Aquarium des Lagons - Nouméa

[New Zealand]
Kelly Tarlton's Sea Life Aquarium - Auckland
Marineland - Napier
National Aquarium of New Zealand - Napier
Southern Encounter Aquarium and Kiwi House - Christchurch

[Palau]
Palau International Coral Reef Center - Koror
